border_size=1
usage=map

Gg      , Gs^Fp   , Gs^Fp   , Gs^Fp   , Gs^Fp   , Gs^Fp   , Gs^Fp   , Gs^Fp   , Gs^Fp   , Gs^Fp   , Gs^Fp   , Gs^Fp   , Re      , Gs^Fp   , Gs^Fp   , Gs^Fp   , Gs^Fp   , Gs^Fp   , Re      , Gs^Fp   , Gs^Fp   , Gs^Fp   , Gs^Fp   , Gs^Fp   , Gs^Fp   , Gs^Fp   
Gg      , Gs^Fp   , Gs^Fp   , Gs^Fp   , Gs^Fp   , Gs^Fp   , Gs^Fp   , Gs^Fp   , Re^Vct  , Gs^Fp   , Gs^Fp   , Gs^Fp   , Ce      , Re      , Gs^Fp   , Gs^Fp   , Gs^Fp   , Re      , Re      , Re      , Gs^Fp   , Gs^Fp   , Gs^Fp   , Gs^Fp   , Gs^Fp   , Gs^Fp   
Re      , Re      , Re      , Re      , Gs^Fp   , Rd      , Gs^Fp   , Gg      , Gg      , Gg      , Ce      , 2 Ke    , Ce      , Gs^Fp   , Gs^Fp   , Gs^Fp   , Re^Vct  , Re      , Re      , Gs^Fp   , Gs^Fp   , Gs^Fp   , Gs^Fp   , Gs^Fp   , Gs^Fp   , Gs^Fp   
Re      , Re      , Re      , Gs^Fp   , Gs^Fp   , Gs^Fp   , Gs^Fp   , Gs^Fp   , Gg      , Gg      , Gg      , Ce      , Ce      , Ce      , Gs^Fp   , Gs^Fp   , Gs^Fp   , Gs^Fp   , Re^Vct  , Gs^Fp   , Gs^Fp   , Gs^Fp   , Gs^Fp   , Gs^Fp   , Gs^Fp   , Gs^Fp   
Re      , Re      , Gs^Fp   , Gs^Fp   , Gg      , Re      , Gg      , Gg      , Gg      , Gg      , Gg      , Gg      , Gg      , Gg      , Gs^Fp   , Gs^Fp   , Gs^Fp   , Gs^Fp   , Gs^Fp   , Gs^Fp   , Gs^Fp   , Re      , Gs^Fp   , Gs^Fp   , Gs^Fp   , Gs^Fp   
Gs^Fp   , Gs^Fp   , Gs^Fp   , Re^Vct  , Gs^Fp   , Gg      , Re      , Gg      , Gg      , Gg      , Gg      , Gg      , Gg      , Gg      , Gg      , Gs^Fp   , Re      , Gs^Fp   , Gs^Fp   , Gs^Fp   , Gs^Fp   , Gs^Fp   , Gs^Fp   , Gs^Fp   , Gs^Fp   , Gs^Fp   
Gs^Fp   , Gs^Fp   , Gs^Fp   , Re      , Gs^Fp   , Gs^Fp   , Gg      , Gg      , Gg      , Re      , Re      , Gg      , Re      , Gg      , Gg      , Gs^Fp   , Gg      , Gs^Fp   , Gs^Fp   , Gs^Fp   , Gs^Fp   , Gs^Fp   , Gs^Fp   , Gs^Fp   , Gs^Fp   , Gs^Fp   
Gs^Fp   , Gs^Fp   , Gs^Fp   , Gs^Fp   , Gs^Fp   , Gs^Fp   , Re      , Gg      , Re      , Re      , Re      , Re      , Gg      , Gg      , Gg      , Gg      , Gg      , Gg      , Gg      , Gg      , Gs^Fp   , Re      , Gs^Fp   , Gs^Fp   , Gs^Fp   , Gs^Fp   
Gs^Fp   , Gs^Fp   , Re      , Gs^Fp   , Gs^Fp   , Gs^Fp   , Gg      , Gg      , Gg      , Re      , Gg      , Gg      , Gg      , Gg      , Gg      , Gg      , Gg      , Gg      , Gg      , Gg      , Gg      , Gg      , Gg      , Gs^Fp   , Gs^Fp   , Gs^Fp   
Gs^Fp   , Gs^Fp   , Gs^Fp   , Gs^Fp   , Gs^Fp   , Gs^Fp   , Gs^Fp   , Gs^Fp   , Gg      , Gg      , Gg      , Gg      , Gg      , Gg      , Gs^Fp   , Gs^Fp   , Gs^Fp   , Re      , Gg      , Re      , Gg      , Gg      , Gg      , Gs^Fp   , Gs^Fp   , Gs^Fp   
Gs^Fp   , Re      , Gs^Fp   , Gs^Fp   , Gs^Fp   , Gs^Fp   , Gg      , Gs^Fp   , Gg      , Re      , Gg      , Gg      , Gg      , Gg      , Gs^Fp   , Gs^Fp   , Gs^Fp   , Gs^Fp   , Gs^Fp   , Gg      , Gg      , Gg      , Gg      , Gg      , Gs^Fp   , Gs^Fp   
Gs^Fp   , Gs^Fp   , Gs^Fp   , Gs^Fp   , Gs^Fp   , Re      , Gg      , Gs^Fp   , Gs^Fp   , Gg      , Gg      , Gg      , Gg      , Gg      , Gg      , Gs^Fp   , Gs^Fp   , Gg^Vh   , Gs^Fp   , Gs^Fp   , Gg      , Re      , Gg      , Gg^Vh   , Gs^Fp   , Gs^Fp   
Gs^Fp   , Gg^Vh   , Gs^Fp   , Gs^Fp   , Gs^Fp   , Gg      , Re      , Gs^Fp   , Gs^Fp   , Gs^Fp   , Gs^Fp   , Re      , Re      , Re      , Re      , Gg      , Re      , Re      , Re      , Gg      , Gg      , Gg      , Gs^Fp   , Gs^Fp   , Gs^Fp   , Gs^Fp   
Gs^Fp   , Gs^Fp   , Gs^Fp   , Gs^Fp   , Gs^Fp   , Re      , Re      , Re      , Re      , Gs^Fp   , Gs^Fp   , Re      , Re      , Re      , Re      , Re      , Re      , Re      , Re      , Gg      , Gg      , Gg      , Gs^Fp   , Gs^Fp   , Gs^Fp   , Gs^Fp   
Gs^Fp   , Gs^Fp   , Gs^Fp   , Re      , Re      , Re      , Gs^Fp   , Re      , Re      , Gs^Fp   , Re      , Re      , Ce      , Re      , Re      , Re      , Gs^Fp   , Re      , Re      , Re      , Re      , Gs^Fp   , Gs^Fp   , Gs^Fp   , Gg^Vh   , Gs^Fp   
Gs^Fp   , Gs^Fp   , Re      , Gs^Fp   , Re      , Re      , Re      , Re      , Re      , Re      , Ce      , Ce      , 1 Ke    , Ce      , Re      , Gg^Vh   , Re      , Re      , Re      , Re      , Re      , Gs^Fp   , Gs^Fp   , Gs^Fp   , Gs^Fp   , Gs^Fp   
Gs^Fp   , Gg^Vh   , Re      , Re      , Re      , Re      , Re      , Re      , Re      , Gs^Fp   , Re      , Ce      , Gg      , Gs^Fp   , Re      , Re      , Re      , Re      , Re      , Re      , Gs^Fp   , Gs^Fp   , Gs^Fp   , Gs^Fp   , Gs^Fp   , Gs^Fp   
Gs^Fp   , Gg      , Re      , Re      , Gs^Fp   , Re      , Gg^Vh   , Gs^Fp   , Re      , Gg      , Gg      , Gs^Fp   , Gg^Vh   , Gg      , Gs^Fp   , Gs^Fp   , Gg      , Gg      , Re      , Gg^Vh   , Gs^Fp   , Gs^Fp   , Gg      , Gg      , Gg      , Gs^Fp   
